<select>
data-select-load="true" ----- load aoutomatik 

data-second-module-id="secmodule" ------   is the id of second select you  want to fill when you select a value 

data-module="MapGenerator"----- MapGenerator is module when you want to make a call but filename is the same 

data-select-relation-field-id="Firstfield"    this attribute is the id where you want to show all field of selected 

data-select-fieldid="FirstfieldID"          ---this attribut is for a button o textfield if you want to add the priamry key of modul  FirstfieldID (is the id of text or ,button ,orr hidden )

data-second-select-file="AllRelation"  ---if you want to get the field for another filoe you only need to write the name of file in this attribute and you can customize the second module fields  AllRelation(is the name of file )

data-second-module-file="nameof file" --if you want to get the data from another php file


--- click a or button or another 
this is to show and hide a 2 elements 

data-showhide-load="true"  attribut tu understand the javascript i want to run this whaen i click

data-tools-id="SecondField,SecondInput"  put inside 2 id of element and you can hide and show (toggle) 



--------------------------- data send button send 

data-send-data-id="ListData,MapName"  ------ the id where you want to take the value

data-send="true"  --- key to understand you want to use those commands 

data-send-url="MapGenerator,SaveTypeMaps"   ------ attribut to keep the modul and the file you want to save 

data-send-saveas="true"    ---------- key to understand you want to use the save as button

data-send-saveas-id-butoni="SaveAsButton"   ------- the id of the button you want to use as save as 

data-send-savehistory="true"    -- key you want to use the history 




// data-history-autorun="true" 

// data-history-autorun-id="LoadHistoryPopup" 

// data-history-autorun-div-relation="LoadShowPopup"



----- for save as 

data-modal-saveas-open="true" -- key to understand if you want to use the modal

data-modal-check-id="id1,id2" -- list of id if you want to check before show a modal 

data-modal-id="ifofmodal" -- the id of modal you want to show

id="SaveAsButton"  -- the id of button 



------------------------------------------------------
------------------------------- load maps ---------------------
----- insert into button or link 

data-autoload-maps="true" --key to aktivate the function

 data-autoload-Filename="MapGenerator,GetAllMaps"   ------- Modul name and the file name to make a ajax call

 data-autoload-Type-Map="ALL"  ---- to filter the Map SQL IO MAPPING etc

 data-autoload-id-relation="GetALLMaps"  -- id to put the values 

---- insert into dropdown

data-select-map-load="true" -------- key to understand you want to execute the function
data-select-map-load-id-relation="GetALLMaps"  ------------- the id of dropdown or input or else where you want to get the values 
data-select-map-load-id-to-show="LoadfromMapSecondStep"   ----------------------- which id you want to put the result 
data-select-map-load-url="MapGenerator,GetMapGeneration" ------------------------ the url when you want to send data



-----------------------for hide 

  data-showhide-load="true"      -------- key to understand 

  data-tools-id="LoadfromMapFirstStep,LoadfromMapSecondStep"   ----------------the id to show and hide 

-----------------------------------------------------------










button 

<button data-load-show="true" data-load-show-relation="FirstModule,Firstfield,secmodule,DefaultValue" data-div-show="LoadShowPopup" class="slds-button slds-button_icon" aria-haspopup="true" title="Click to add " style="width:2.1rem;">

data-load-show="true"   understand the server when you click to run this code

data-load-show-relation="FirstModule,Firstfield,secmodule,DefaultValue"  are the id you want to execute the and to take the val

data-div-show="LoadShowPopup"    to show the popup if you want 



data-add-button-popup="true"   is for show the modal of selected fields used in <button> <a> or another element of html 




data-label-change-load="true"  understand the server you want to use that function when change the value (only for dropdown)
data-select-filename=""        the file name where you want to get data 
data-set-value-to=""           the id of html component to save the value
data-module="MapGenerator"    the name of modul you are working


input thoose are for show the message when yu write in input 

id="nameView"    --------------Id of input you want to write
data-controll="true"    ------------ to understand the javascript you want to use this function
data-controll-idlabel="ShowErorrNameMap"   ------------- the id when you want to show the message 
data-controll-file="MapGenerator,CheckNameOfMap"  ---------------- Moduls and file when you want to call for check something
data-controll-id-relation="TypeMaps"   -----------TypeOFMaps is another html element whis is disambled and when the condition is true this make disabled false



